37 37 37 37 37 37 37 37 37 37 37 45 46 46 46 46 46 46 47 37 37 37 37 37 37 37 37 37 37 37 37 37 37 37 37 37 37 37 37 37 
37 37 37 37 37 39 40 40 40 40 40 49 46 46 46 46 46 46 47 37 37 37 37 37 37 37 37 37 37 37 37 37 37 37 37 37 37 37 37 37 
37 37 37 37 37 45 46 46 46 46 46 46 46 46 46 46 46 46 47 37 37 37 37 37 37 37 37 37 37 37 37 37 37 37 37 37 37 37 37 37 
40 40 40 40 40 49 46 46 46 46 46 46 46 46 46 46 46 46 47 37 37 37 37 37 37 37 37 37 37 37 37 37 37 37 37 37 37 37 37 37 
46 46 46 46 46 46 46 46 46 46 46 46 46 46 46 46 46 46 47 37 37 37 37 37 37 37 37 37 37 37 37 37 37 37 37 37 37 37 37 37 
46 46 46 46 46 46 46 46 46 46 46 46 46 46 46 46 46 46 48 40 40 40 41 37 37 37 37 37 37 37 37 37 37 39 40 40 40 40 40 40 
46 46 46 46 46 46 46 46 46 46 46 46 46 46 46 46 46 46 46 46 46 46 47 37 37 37 37 37 37 37 37 37 37 45 46 46 46 46 46 46 
46 46 46 46 46 46 46 46 46 46 46 46 46 46 46 46 46 46 46 46 46 46 47 37 37 37 37 37 37 37 37 37 37 45 46 46 46 46 46 46 
46 46 46 46 46 46 46 46 46 46 46 46 46 46 46 46 46 46 46 46 46 46 48 40 40 40 40 40 40 40 40 40 40 46 46 46 46 46 46 46 
46 46 46 46 46 46 46 46 46 46 46 46 46 46 46 46 46 46 46 46 46 46 46 46 46 46 46 46 46 46 46 46 46 46 46 46 46 46 46 46 
46 46 46 46 46 46 46 46 46 46 46 46 46 46 46 46 46 46 46 46 46 46 46 46 46 46 46 46 46 46 46 46 46 46 46 46 46 46 46 46 
52 52 52 52 52 52 52 52 52 52 52 46 46 46 46 46 46 46 46 46 46 46 46 46 46 46 46 46 46 46 46 46 46 46 46 46 46 46 46 46 
37 37 37 37 37 37 37 37 37 37 37 51 43 46 46 46 46 46 46 46 46 46 46 46 46 46 46 46 46 46 46 46 46 46 46 46 46 46 46 46 
37 37 37 37 37 37 37 37 37 37 37 37 45 46 46 46 46 46 46 46 46 46 46 46 46 46 46 46 46 46 46 46 46 46 46 46 46 46 46 46 
37 37 37 37 37 37 37 37 37 37 37 37 45 46 46 46 46 46 46 46 46 46 46 46 52 52 52 52 52 52 52 52 52 52 52 52 52 52 52 52 
37 37 37 37 37 37 37 37 37 37 39 40 49 46 46 46 46 46 46 46 46 46 46 47 37 37 37 37 37 37 37 37 37 37 37 37 37 37 37 37 
37 37 37 37 37 37 37 37 37 37 51 52 52 52 52 52 52 52 52 52 52 52 52 53 37 37 37 37 37 37 37 37 37 37 37 37 37 37 37 37 
37 37 37 37 37 37 37 37 37 37 37 37 37 37 37 37 37 37 37 37 37 37 37 37 37 37 37 37 37 37 37 37 37 37 37 37 37 37 37 37 
37 37 37 37 37 37 37 37 37 37 37 37 37 37 37 37 37 37 37 37 37 37 37 37 37 37 37 37 37 37 37 37 37 37 37 37 37 37 37 37 
37 37 37 37 37 37 37 37 37 37 37 37 37 37 37 37 37 37 37 37 37 37 37 37 37 37 37 37 37 37 37 37 37 37 37 37 37 37 37 37 